0x000000ff
0x001a80ff
0xe6e6e6ff
0x333333ff
0x334db3ff
0xccccccff
